check_chars.c	   ft_isascii.c      ft_memset.c      ft_strjoin.c
free_tpool.c	   ft_isdigit.c      ft_min.c	      ft_strjoin_free.c
ft_abs.c	   ft_ishexa.c	     ft_perror.c      ft_strlcat.c
ft_atof.c	   ft_isprint.c      ft_putchar.c     ft_strlen.c
ft_atoi.c	   ft_itoa.c	     ft_putchar_fd.c  ft_strmap.c
ft_atoi_base.c	   ft_lstadd.c	     ft_putendl.c     ft_strmapi.c
ft_bzero.c	   ft_lstcontains.c  ft_putendl_fd.c  ft_strncat.c
ft_clamp.c	   ft_lstdel.c	     ft_putnbr.c      ft_strncmp.c
ft_convert_base.c  ft_lstdelfront.c  ft_putnbr_fd.c   ft_strncpy.c
ft_count.c	   ft_lstdelnode.c   ft_putstr.c      ft_strnequ.c
ft_delindex.c	   ft_lstdelone.c    ft_putstr_fd.c   ft_strnew.c
ft_dlstbackward.c  ft_lstiter.c      ft_realloc.c     ft_strnstr.c
ft_dlstdelfront.c  ft_lstlen.c	     ft_rmchar.c      ft_strrchr.c
ft_dlstforward.c   ft_lstmap.c	     ft_sitoa.c       ft_strsplit.c
ft_dlstinsert.c    ft_lstnew.c	     ft_strcat.c      ft_strstr.c
ft_dlstlen.c	   ft_lstpopfront.c  ft_strchr.c      ft_strsub.c
ft_dlstnew.c	   ft_lstpushback.c  ft_strclr.c      ft_strtrim.c
ft_fabs.c	   ft_max.c	     ft_strcmp.c      ft_tolower.c
ft_fclamp.c	   ft_memalloc.c     ft_strcpy.c      ft_toupper.c
ft_fmax.c	   ft_memccpy.c      ft_strdel.c      get_next_line.c
ft_fmin.c	   ft_memchr.c	     ft_strdup.c      init_tpool.c
ft_getlen.c	   ft_memcmp.c	     ft_strequ.c      skip_chars.c
ft_getsize.c	   ft_memcpy.c	     ft_stricmp.c     thread_pool.c
ft_isalnum.c	   ft_memdel.c	     ft_striter.c     thread_pool_work.c
ft_isalpha.c	   ft_memmove.c      ft_striteri.c
